[pida.editors]
culebraedit = pida.editors.culebraedit:Service
vimmultiedit = pida.editors.vimmultiedit:Service
mooedit = pida.editors.mooedit:Service
vimedit = pida.editors.vimedit:Service

[pida.services]
projectcreator = pida.services.projectcreator:Service
help = pida.services.help:Service
grepper = pida.services.grepper:Service
library = pida.services.library:Service
documenttypes = pida.services.documenttypes:Service
rpc = pida.services.rpc:Service
languagetypes = pida.services.languagetypes:Service
versioncontrol = pida.services.versioncontrol:Service
buffermanager = pida.services.buffermanager:Service
keyboardshortcuts = pida.services.keyboardshortcuts:Service
menubar = pida.services.menubar:Service
filemanager = pida.services.filemanager:Service
window = pida.services.window:Service
tempfilecreator = pida.services.tempfilecreator:Service
terminal = pida.services.terminal:Service
python = pida.services.python:Service
pastemanager = pida.services.pastemanager:Service
editormanager = pida.services.editormanager:Service
pythonbrowser = pida.services.pythonbrowser:Service
openwith = pida.services.openwith:Service
newfile = pida.services.newfile:Service
meldembed = pida.services.meldembed:Service
gazpach = pida.services.gazpach:Service
configmanager = pida.services.configmanager:Service
manhole = pida.services.manhole:Service
scripts = pida.services.scripts:Service
projectmanager = pida.services.projectmanager:Service
servicediagnostics = pida.services.servicediagnostics:Service
pyflaker = pida.services.pyflaker:Service
contexts = pida.services.contexts:Service
logmanager = pida.services.logmanager:Service
webbrowse = pida.services.webbrowse:Service
projecttypes = pida.services.projecttypes:Service
todolist = pida.services.todolist:Service

[console_scripts]
pida = pida.core.application:main

[pida.plugins]


[gui_scripts]


