
      [distutils.commands]
      generate_api = nagare.doc.setuplib:GenerateAPI [doc]
      generate_html = nagare.doc.setuplib:GenerateHTML [doc]

      [console_scripts]
      nagare-admin = nagare.admin.main:main

      [nagare.commands]
      info = nagare.admin.info:Info
      serve = nagare.admin.serve:Serve
      serve-module = nagare.admin.serve_module:Serve
      create-app = nagare.admin.create:Create
      create-db = nagare.admin.db:DBCreate
      drop-db = nagare.admin.db:DBDrop
      shell = nagare.admin.shell:Shell
      batch = nagare.admin.shell:Batch
      create-rules = nagare.admin.create_rules:CreateRules

      [nagare.publishers]
      standalone = nagare.publishers.standalone_publisher:Publisher
      threaded = nagare.publishers.standalone_publisher:Publisher
      fastcgi = nagare.publishers.fcgi_publisher:Publisher
      fapws2 = nagare.publishers.fapws_publisher:Publisher
      eventlet = nagare.publishers.eventlet_publisher:Publisher

      [nagare.sessions]
      standalone = nagare.sessions.memory_sessions:SessionsWithPickledStates
      pickle = nagare.sessions.memory_sessions:SessionsWithPickledStates
      memory = nagare.sessions.memory_sessions:SessionsWithMemoryStates
      memcache = nagare.sessions.memcached_sessions:Sessions

      [nagare.applications]
      admin = nagare.admin.admin_app:app

      [nagare.admin]
      info = nagare.admin.interface.info:Admin
      apps = nagare.admin.interface.applications:Admin
      